4,4,4,4,4,4,4,4,4,4,4,4,4,4,4,4,1,1,1,1,2,1,1,1,1,4,4,4,4,4,4,4,4,4,4,4,4,4,4,4,4,
4,4,4,4,4,4,4,4,4,4,4,4,4,4,4,1,1,1,1,1,0,1,1,1,1,1,4,4,4,4,4,4,4,4,4,4,4,4,4,4,4,
4,4,4,4,4,4,4,4,4,4,4,4,4,4,1,1,1,1,0,0,0,0,0,1,1,1,1,4,4,4,4,4,4,4,4,4,4,4,4,4,4,
4,4,4,4,4,4,4,4,4,4,4,4,4,1,1,1,1,1,0,1,1,1,0,1,1,1,1,1,4,4,4,4,4,4,4,4,4,4,4,4,4,
4,4,4,4,4,4,4,4,4,4,4,4,1,1,0,0,0,0,0,5,5,5,0,0,0,0,0,1,1,4,4,4,4,4,4,4,4,4,4,4,4,
4,4,4,4,4,4,4,4,4,4,4,4,1,1,0,1,1,1,5,8,8,8,5,1,1,1,0,1,1,4,4,4,4,4,4,4,4,4,4,4,4,
4,4,4,4,4,4,4,4,4,4,4,4,1,1,0,1,1,1,5,8,8,8,5,1,1,1,0,1,1,4,4,4,4,4,4,4,4,4,4,4,4,
4,4,4,4,4,4,4,4,4,4,4,4,1,1,0,0,0,1,0,0,0,0,0,1,0,0,0,1,1,4,4,4,4,4,4,4,4,4,4,4,4,
4,4,4,4,4,4,4,4,4,4,4,4,1,1,1,1,0,1,0,1,0,1,0,1,0,1,1,1,1,4,4,4,4,4,4,4,4,4,4,4,4,
4,4,4,4,4,4,4,4,4,4,4,4,1,1,1,1,0,0,0,1,0,1,0,0,0,1,1,1,1,4,4,4,4,4,4,4,4,4,4,4,4,
4,4,4,4,4,4,4,4,4,4,4,4,1,1,5,5,5,5,5,5,0,5,5,5,5,5,5,1,1,4,4,4,4,4,4,4,4,4,4,4,4,
4,4,4,4,4,4,4,4,4,4,4,4,1,1,5,0,0,0,0,0,0,0,0,0,0,0,5,1,1,4,4,4,4,4,4,4,4,4,4,4,4,
4,4,4,4,1,1,1,1,1,1,1,1,3,1,5,0,1,1,1,1,1,1,1,1,1,0,5,1,3,1,1,1,1,1,1,1,1,4,4,4,4,
4,4,4,1,1,1,1,1,1,1,1,1,1,3,5,0,0,0,0,0,0,0,0,0,0,0,5,3,1,1,1,1,1,1,1,1,1,1,4,4,4,
4,4,1,1,0,0,0,0,1,1,5,5,5,5,3,5,5,5,5,5,0,5,5,5,5,5,3,5,5,5,5,1,1,0,0,0,0,1,1,4,4,
4,1,1,1,0,1,1,0,1,1,5,0,0,0,5,11,8,8,8,1,0,1,8,8,8,11,5,0,0,0,5,1,1,0,1,1,0,1,1,1,4,
1,1,1,1,0,1,1,0,0,0,5,0,1,0,5,8,11,8,8,1,0,1,8,8,11,8,5,0,1,0,5,0,0,0,1,1,0,1,1,1,1,
1,1,1,1,0,1,1,1,1,0,5,0,1,0,5,8,8,11,8,1,0,1,8,11,8,8,5,0,1,0,5,0,1,1,1,1,0,1,1,1,1,
1,1,0,0,0,5,5,0,0,0,5,0,1,0,5,8,8,8,11,1,0,1,11,8,8,8,5,0,1,0,5,0,0,0,5,5,0,0,0,1,1,
1,1,0,1,5,8,8,0,1,1,5,0,1,0,5,1,1,1,1,3,0,3,1,1,1,1,5,0,1,0,5,1,1,0,8,8,5,1,0,1,1,
2,0,0,1,5,8,8,0,0,0,0,0,1,0,0,0,0,0,0,0,0,0,0,0,0,0,0,0,1,0,0,0,0,0,8,8,5,1,0,0,2,
1,1,0,1,5,8,8,0,1,1,5,0,1,0,5,1,1,1,1,3,0,3,1,1,1,1,5,0,1,0,5,1,1,0,8,8,5,1,0,1,1,
1,1,0,0,0,5,5,0,0,0,5,0,1,0,5,8,8,8,11,1,0,1,11,8,8,8,5,0,1,0,5,0,0,0,5,5,0,0,0,1,1,
1,1,1,1,0,1,1,1,1,0,5,0,1,0,5,8,8,11,8,1,0,1,8,11,8,8,5,0,1,0,5,0,1,1,1,1,0,1,1,1,1,
1,1,1,1,0,1,1,0,0,0,5,0,1,0,5,8,11,8,8,1,0,1,8,8,11,8,5,0,1,0,5,0,0,0,1,1,0,1,1,1,1,
4,1,1,1,0,1,1,0,1,1,5,0,0,0,5,11,8,8,8,1,0,1,8,8,8,11,5,0,0,0,5,1,1,0,1,1,0,1,1,1,4,
4,4,1,1,0,0,0,0,1,1,5,5,5,5,3,5,5,5,5,5,0,5,5,5,5,5,3,5,5,5,5,1,1,0,0,0,0,1,1,4,4,
4,4,4,1,1,1,1,1,1,1,1,1,1,3,5,0,0,0,0,0,0,0,0,0,0,0,5,3,1,1,1,1,1,1,1,1,1,1,4,4,4,
4,4,4,4,1,1,1,1,1,1,1,1,3,1,5,0,1,1,1,1,1,1,1,1,1,0,5,1,3,1,1,1,1,1,1,1,1,4,4,4,4,
4,4,4,4,4,4,4,4,4,4,4,4,1,1,5,0,0,0,0,0,0,0,0,0,0,0,5,1,1,4,4,4,4,4,4,4,4,4,4,4,4,
4,4,4,4,4,4,4,4,4,4,4,4,1,1,5,5,5,5,5,5,0,5,5,5,5,5,5,1,1,4,4,4,4,4,4,4,4,4,4,4,4,
4,4,4,4,4,4,4,4,4,4,4,4,1,1,1,1,0,0,0,1,0,1,0,0,0,1,1,1,1,4,4,4,4,4,4,4,4,4,4,4,4,
4,4,4,4,4,4,4,4,4,4,4,4,1,1,1,1,0,1,0,1,0,1,0,1,0,1,1,1,1,4,4,4,4,4,4,4,4,4,4,4,4,
4,4,4,4,4,4,4,4,4,4,4,4,1,1,0,0,0,1,0,0,0,0,0,1,0,0,0,1,1,4,4,4,4,4,4,4,4,4,4,4,4,
4,4,4,4,4,4,4,4,4,4,4,4,1,1,0,1,1,1,5,8,8,8,5,1,1,1,0,1,1,4,4,4,4,4,4,4,4,4,4,4,4,
4,4,4,4,4,4,4,4,4,4,4,4,1,1,0,1,1,1,5,8,8,8,5,1,1,1,0,1,1,4,4,4,4,4,4,4,4,4,4,4,4,
4,4,4,4,4,4,4,4,4,4,4,4,1,1,0,0,0,0,0,5,5,5,0,0,0,0,0,1,1,4,4,4,4,4,4,4,4,4,4,4,4,
4,4,4,4,4,4,4,4,4,4,4,4,4,1,1,1,1,1,0,1,1,1,0,1,1,1,1,1,4,4,4,4,4,4,4,4,4,4,4,4,4,
4,4,4,4,4,4,4,4,4,4,4,4,4,4,1,1,1,1,0,0,0,0,0,1,1,1,1,4,4,4,4,4,4,4,4,4,4,4,4,4,4,
4,4,4,4,4,4,4,4,4,4,4,4,4,4,4,1,1,1,1,1,0,1,1,1,1,1,4,4,4,4,4,4,4,4,4,4,4,4,4,4,4,
4,4,4,4,4,4,4,4,4,4,4,4,4,4,4,4,1,1,1,1,2,1,1,1,1,4,4,4,4,4,4,4,4,4,4,4,4,4,4,4,4,
