3,4,4,4,4,4,4,4,4,4,4,4,1,1,1,1,1,1,1,1,9,1,1,1,1,1,1,1,1,4,4,4,4,4,4,4,4,4,4,4,3
4,3,4,4,4,4,4,4,4,4,4,4,1,1,1,1,1,1,0,0,0,0,0,1,1,1,1,1,1,4,4,4,4,4,4,4,4,4,4,3,4
4,4,3,4,4,4,4,4,4,4,4,4,1,1,1,1,1,1,0,1,1,1,0,1,1,1,1,1,1,4,4,4,4,4,4,4,4,4,3,4,4
4,4,4,3,4,4,4,4,4,4,4,4,1,1,1,1,1,1,0,1,1,1,0,1,1,1,1,1,1,4,4,4,4,4,4,4,4,3,4,4,4
4,4,4,4,3,4,4,4,4,4,4,4,1,1,0,0,0,0,0,5,5,5,0,0,0,0,0,1,1,4,4,4,4,4,4,4,3,4,4,4,4
4,4,4,4,4,3,4,4,4,4,4,4,1,1,0,1,1,1,1,1,5,1,1,1,1,1,0,1,1,4,4,4,4,4,4,3,4,4,4,4,4
4,4,4,4,4,4,3,4,4,4,4,4,1,1,0,1,1,1,1,1,5,1,1,1,1,1,0,1,1,4,4,4,4,4,3,4,4,4,4,4,4
4,4,4,4,4,4,4,3,4,4,4,4,1,1,0,0,0,1,0,0,0,0,0,1,0,0,0,1,1,4,4,4,4,3,4,4,4,4,4,4,4
4,4,4,4,4,4,4,4,3,4,4,4,1,1,1,1,0,1,0,1,0,1,0,1,0,1,1,1,1,4,4,4,3,4,4,4,4,4,4,4,4
4,4,4,4,4,4,4,4,4,3,4,4,1,1,1,1,0,0,0,1,0,1,0,0,0,1,1,1,1,4,4,3,4,4,4,4,4,4,4,4,4
4,4,4,4,4,4,4,4,4,4,3,4,1,1,5,5,5,5,5,5,0,5,5,5,5,5,5,1,1,4,3,4,4,4,4,4,4,4,4,4,4
4,4,4,4,4,4,4,4,4,4,4,3,1,1,5,0,0,0,0,0,0,0,0,0,0,0,5,1,1,3,4,4,4,4,4,4,4,4,4,4,4
1,1,1,1,1,1,1,1,1,1,1,1,3,1,5,0,1,1,1,1,1,1,1,1,1,0,5,1,3,1,1,1,1,1,1,1,1,1,1,1,1
1,1,1,1,1,1,1,1,1,1,1,1,1,3,5,0,0,0,0,0,0,0,0,0,0,0,5,3,1,1,1,1,1,1,1,1,1,1,1,1,1
1,1,1,1,0,0,0,0,1,1,5,5,5,5,3,5,5,5,5,5,0,5,5,5,5,5,3,5,5,5,5,1,1,0,0,0,0,1,1,1,1
1,1,1,1,0,1,1,0,1,1,5,0,0,0,5,3,1,1,1,1,0,1,1,1,1,3,5,0,0,0,5,1,1,0,1,1,0,1,1,1,1
1,1,1,1,0,1,1,0,0,0,5,0,1,0,5,1,3,1,1,1,0,1,1,1,3,1,5,0,1,0,5,0,0,0,1,1,0,1,1,1,1
1,1,1,1,0,1,1,1,1,0,5,0,1,0,5,1,1,3,1,1,0,1,1,3,1,1,5,0,1,0,5,0,1,1,1,1,0,1,1,1,1
1,0,0,0,0,1,1,0,0,0,5,0,1,0,5,1,1,1,3,1,0,1,3,1,1,1,5,0,1,0,5,0,0,0,1,1,0,0,0,0,1
1,0,1,1,5,1,1,0,1,1,5,0,1,0,5,1,1,1,1,3,0,3,1,1,1,1,5,0,1,0,5,1,1,0,1,1,5,1,1,0,1
9,0,1,1,5,5,5,0,0,0,0,0,1,0,0,0,0,0,0,0,0,0,0,0,0,0,0,0,1,0,0,0,0,0,5,5,5,1,1,0,9
1,0,1,1,5,1,1,0,1,1,5,0,1,0,5,1,1,1,1,3,0,3,1,1,1,1,5,0,1,0,5,1,1,0,1,1,5,1,1,0,1
1,0,0,0,0,1,1,0,0,0,5,0,1,0,5,1,1,1,3,1,0,1,3,1,1,1,5,0,1,0,5,0,0,0,1,1,0,0,0,0,1
1,1,1,1,0,1,1,1,1,0,5,0,1,0,5,1,1,3,1,1,0,1,1,3,1,1,5,0,1,0,5,0,1,1,1,1,0,1,1,1,1
1,1,1,1,0,1,1,0,0,0,5,0,1,0,5,1,3,1,1,1,0,1,1,1,3,1,5,0,1,0,5,0,0,0,1,1,0,1,1,1,1
1,1,1,1,0,1,1,0,1,1,5,0,0,0,5,3,1,1,1,1,0,1,1,1,1,3,5,0,0,0,5,1,1,0,1,1,0,1,1,1,1
1,1,1,1,0,0,0,0,1,1,5,5,5,5,3,5,5,5,5,5,0,5,5,5,5,5,3,5,5,5,5,1,1,0,0,0,0,1,1,1,1
1,1,1,1,1,1,1,1,1,1,1,1,1,3,5,0,0,0,0,0,0,0,0,0,0,0,5,3,1,1,1,1,1,1,1,1,1,1,1,1,1
1,1,1,1,1,1,1,1,1,1,1,1,3,1,5,0,1,1,1,1,1,1,1,1,1,0,5,1,3,1,1,1,1,1,1,1,1,1,1,1,1
1,1,1,1,1,1,1,1,1,1,1,3,1,1,5,0,0,0,0,0,0,0,0,0,0,0,5,1,1,3,1,1,1,1,1,1,1,1,1,1,1
4,4,4,4,4,4,4,4,4,4,3,4,1,1,5,5,5,5,5,5,0,5,5,5,5,5,5,1,1,1,3,4,4,4,4,4,4,4,4,4,4
4,4,4,4,4,4,4,4,4,3,4,4,1,1,1,1,0,0,0,1,0,1,0,0,0,1,1,1,1,1,4,3,4,4,4,4,4,4,4,4,4
4,4,4,4,4,4,4,4,3,4,4,4,1,1,1,1,0,1,0,1,0,1,0,1,0,1,1,1,1,1,4,4,3,4,4,4,4,4,4,4,4
4,4,4,4,4,4,4,3,4,4,4,4,1,1,0,0,0,1,0,0,0,0,0,1,0,0,0,1,1,1,4,4,4,3,4,4,4,4,4,4,4
4,4,4,4,4,4,3,4,4,4,4,4,1,1,0,1,1,1,1,1,5,1,1,1,1,1,0,1,1,1,4,4,4,4,3,4,4,4,4,4,4
4,4,4,4,4,3,4,4,4,4,4,4,1,1,0,1,1,1,1,1,5,1,1,1,1,1,0,1,1,1,4,4,4,4,4,3,4,4,4,4,4
4,4,4,4,3,4,4,4,4,4,4,4,1,1,0,0,0,0,0,5,5,5,0,0,0,0,0,1,1,1,4,4,4,4,4,4,3,4,4,4,4
4,4,4,3,4,4,4,4,4,4,4,4,1,1,1,1,1,1,0,1,1,1,0,1,1,1,1,1,1,1,4,4,4,4,4,4,4,3,4,4,4
4,4,3,4,4,4,4,4,4,4,4,4,1,1,1,1,1,1,0,1,1,1,0,1,1,1,1,1,1,1,4,4,4,4,4,4,4,4,3,4,4
4,3,4,4,4,4,4,4,4,4,4,4,1,1,1,1,1,1,0,0,0,0,0,1,1,1,1,1,1,1,4,4,4,4,4,4,4,4,4,3,4
3,4,4,4,4,4,4,4,4,4,4,4,1,1,1,1,1,1,1,1,9,1,1,1,1,1,1,1,1,1,4,4,4,4,4,4,4,4,4,4,3
