3,1,1,1,1,1,1,1,1,1,1,1,0,0,0,0,0,0,0,0,27,0,0,0,0,0,0,0,0,1,1,1,1,1,1,1,1,1,1,1,3
1,3,1,1,1,1,1,1,1,1,1,1,0,0,0,0,0,0,8,8,8,8,8,0,0,0,0,0,0,1,1,1,1,1,1,1,1,1,1,3,1
1,1,3,1,1,1,1,1,1,1,1,1,0,0,0,0,0,0,8,0,0,0,8,0,0,0,0,0,0,1,1,1,1,1,1,1,1,1,3,1,1
1,1,1,3,1,1,1,1,1,1,1,1,0,0,0,0,0,0,8,0,0,0,8,0,0,0,0,0,0,1,1,1,1,1,1,1,1,3,1,1,1
1,1,1,1,3,1,1,1,1,1,1,1,0,0,8,8,8,8,8,2,2,2,8,8,8,8,8,0,0,1,1,1,1,1,1,1,3,1,1,1,1
1,1,1,1,1,3,1,1,1,1,1,1,0,0,8,0,0,0,0,0,2,0,0,0,0,0,8,0,0,1,1,1,1,1,1,3,1,1,1,1,1
1,1,1,1,1,1,3,1,1,1,1,1,0,0,8,0,0,0,0,0,2,0,0,0,0,0,8,0,0,1,1,1,1,1,3,1,1,1,1,1,1
1,1,1,1,1,1,1,3,1,1,1,1,0,0,8,8,8,0,8,8,8,8,8,0,8,8,8,0,0,1,1,1,1,3,1,1,1,1,1,1,1
1,1,1,1,1,1,1,1,3,1,1,1,0,0,0,0,8,0,8,0,8,0,8,0,8,0,0,0,0,1,1,1,3,1,1,1,1,1,1,1,1
1,1,1,1,1,1,1,1,1,3,1,1,0,0,0,0,8,8,8,0,8,0,8,8,8,0,0,0,0,1,1,3,1,1,1,1,1,1,1,1,1
1,1,1,1,1,1,1,1,1,1,3,1,0,0,2,2,2,2,2,2,8,2,2,2,2,2,2,0,0,1,3,1,1,1,1,1,1,1,1,1,1
1,1,1,1,1,1,1,1,1,1,1,3,0,0,2,8,8,8,8,8,8,8,8,8,8,8,2,0,0,3,1,1,1,1,1,1,1,1,1,1,1
0,0,0,0,0,0,0,0,0,0,0,0,3,0,2,8,0,0,0,0,0,0,0,0,0,8,2,0,3,0,0,0,0,0,0,0,0,0,0,0,0
0,0,0,0,0,0,0,0,0,0,0,0,0,3,2,8,8,8,8,8,8,8,8,8,8,8,2,3,0,0,0,0,0,0,0,0,0,0,0,0,0
0,0,0,0,8,8,8,8,0,0,2,2,2,2,3,2,2,2,2,2,8,2,2,2,2,2,3,2,2,2,2,0,0,8,8,8,8,0,0,0,0
0,0,0,0,8,0,0,8,0,0,2,8,8,8,2,3,0,0,0,0,8,0,0,0,0,3,2,8,8,8,2,0,0,8,0,0,8,0,0,0,0
0,0,0,0,8,0,0,8,8,8,2,8,0,8,2,0,3,0,0,0,8,0,0,0,3,0,2,8,0,8,2,8,8,8,0,0,8,0,0,0,0
0,0,0,0,8,0,0,0,0,8,2,8,0,8,2,0,0,3,0,0,8,0,0,3,0,0,2,8,0,8,2,8,0,0,0,0,8,0,0,0,0
0,8,8,8,8,0,0,8,8,8,2,8,0,8,2,0,0,0,3,0,8,0,3,0,0,0,2,8,0,8,2,8,8,8,0,0,8,8,8,8,0
0,8,0,0,2,0,0,8,0,0,2,8,0,8,2,0,0,0,0,3,8,3,0,0,0,0,2,8,0,8,2,0,0,8,0,0,2,0,0,8,0
27,8,0,0,2,2,2,8,8,8,8,8,0,8,8,8,8,8,8,8,8,8,8,8,8,8,8,8,0,8,8,8,8,8,2,2,2,0,0,8,27
0,8,0,0,2,0,0,8,0,0,2,8,0,8,2,0,0,0,0,3,8,3,0,0,0,0,2,8,0,8,2,0,0,8,0,0,2,0,0,8,0
0,8,8,8,8,0,0,8,8,8,2,8,0,8,2,0,0,0,3,0,8,0,3,0,0,0,2,8,0,8,2,8,8,8,0,0,8,8,8,8,0
0,0,0,0,8,0,0,0,0,8,2,8,0,8,2,0,0,3,0,0,8,0,0,3,0,0,2,8,0,8,2,8,0,0,0,0,8,0,0,0,0
0,0,0,0,8,0,0,8,8,8,2,8,0,8,2,0,3,0,0,0,8,0,0,0,3,0,2,8,0,8,2,8,8,8,0,0,8,0,0,0,0
0,0,0,0,8,0,0,8,0,0,2,8,8,8,2,3,0,0,0,0,8,0,0,0,0,3,2,8,8,8,2,0,0,8,0,0,8,0,0,0,0
0,0,0,0,8,8,8,8,0,0,2,2,2,2,3,2,2,2,2,2,8,2,2,2,2,2,3,2,2,2,2,0,0,8,8,8,8,0,0,0,0
0,0,0,0,0,0,0,0,0,0,0,0,0,3,2,8,8,8,8,8,8,8,8,8,8,8,2,3,0,0,0,0,0,0,0,0,0,0,0,0,0
0,0,0,0,0,0,0,0,0,0,0,0,3,0,2,8,0,0,0,0,0,0,0,0,0,8,2,0,3,0,0,0,0,0,0,0,0,0,0,0,0
0,0,0,0,0,0,0,0,0,0,0,3,0,0,2,8,8,8,8,8,8,8,8,8,8,8,2,0,0,3,0,0,0,0,0,0,0,0,0,0,0
1,1,1,1,1,1,1,1,1,1,3,1,0,0,2,2,2,2,2,2,8,2,2,2,2,2,2,0,0,0,3,1,1,1,1,1,1,1,1,1,1
1,1,1,1,1,1,1,1,1,3,1,1,0,0,0,0,8,8,8,0,8,0,8,8,8,0,0,0,0,0,1,3,1,1,1,1,1,1,1,1,1
1,1,1,1,1,1,1,1,3,1,1,1,0,0,0,0,8,0,8,0,8,0,8,0,8,0,0,0,0,0,1,1,3,1,1,1,1,1,1,1,1
1,1,1,1,1,1,1,3,1,1,1,1,0,0,8,8,8,0,8,8,8,8,8,0,8,8,8,0,0,0,1,1,1,3,1,1,1,1,1,1,1
1,1,1,1,1,1,3,1,1,1,1,1,0,0,8,0,0,0,0,0,2,0,0,0,0,0,8,0,0,0,1,1,1,1,3,1,1,1,1,1,1
1,1,1,1,1,3,1,1,1,1,1,1,0,0,8,0,0,0,0,0,2,0,0,0,0,0,8,0,0,0,1,1,1,1,1,3,1,1,1,1,1
1,1,1,1,3,1,1,1,1,1,1,1,0,0,8,8,8,8,8,2,2,2,8,8,8,8,8,0,0,0,1,1,1,1,1,1,3,1,1,1,1
1,1,1,3,1,1,1,1,1,1,1,1,0,0,0,0,0,0,8,0,0,0,8,0,0,0,0,0,0,0,1,1,1,1,1,1,1,3,1,1,1
1,1,3,1,1,1,1,1,1,1,1,1,0,0,0,0,0,0,8,0,0,0,8,0,0,0,0,0,0,0,1,1,1,1,1,1,1,1,3,1,1
1,3,1,1,1,1,1,1,1,1,1,1,0,0,0,0,0,0,8,8,8,8,8,0,0,0,0,0,0,0,1,1,1,1,1,1,1,1,1,3,1
3,1,1,1,1,1,1,1,1,1,1,1,0,0,0,0,0,0,0,0,27,0,0,0,0,0,0,0,0,0,1,1,1,1,1,1,1,1,1,1,3
