13,14,14,14,14,14,14,14,14,14,14,14,14,14,14,8,9,9,9,9,9,8,8,22,22,22,22,22,22,22,22,22,22,8,0,9,9,9,8,9,13
14,13,14,14,14,12,12,12,12,12,12,14,12,12,12,12,9,9,9,9,8,22,22,22,8,9,9,9,9,8,22,22,22,9,12,9,8,9,9,13,9
14,14,13,14,14,12,9,9,9,9,12,14,12,9,8,12,12,12,12,9,9,22,22,22,8,9,12,12,12,8,22,22,22,9,12,9,8,9,13,9,8
14,14,14,13,14,12,12,12,12,9,12,12,12,9,9,9,9,9,12,9,12,12,12,12,9,8,12,9,12,9,9,9,9,12,12,9,9,13,9,9,9
14,14,14,14,13,14,14,14,12,9,8,8,9,9,9,9,9,9,12,9,12,9,9,12,9,9,12,9,12,12,12,12,12,12,9,9,13,9,8,8,9
14,12,12,12,14,13,14,14,12,12,9,9,12,12,12,12,9,9,12,8,12,12,9,12,9,9,12,9,9,9,9,9,9,9,9,13,9,9,9,9,9
14,12,9,12,14,14,13,14,14,12,12,9,12,14,14,12,8,9,12,8,9,12,8,12,9,9,12,9,8,9,9,9,8,9,13,9,9,12,12,12,0
14,12,9,12,14,14,14,13,14,14,12,12,12,14,14,12,8,9,12,9,9,12,9,12,12,12,12,9,9,9,8,9,9,13,9,9,12,12,9,9,8
14,12,9,12,12,12,14,14,13,14,14,14,14,14,14,12,8,9,12,12,12,12,9,9,9,8,9,9,9,9,9,9,13,9,8,9,12,9,22,22,22
14,12,9,9,9,12,12,14,14,13,14,14,14,14,14,12,9,9,9,9,9,9,9,9,9,9,9,9,9,9,9,13,9,9,9,9,12,9,22,22,22
14,12,12,12,8,9,12,12,14,14,6,6,6,6,6,12,6,6,6,6,6,6,6,6,6,6,6,6,6,6,6,9,9,8,9,9,12,9,22,22,22
14,14,14,12,8,9,9,12,14,14,6,6,10,10,4,12,4,18,12,12,12,12,12,4,10,10,10,10,10,6,6,9,9,9,9,9,12,9,8,8,22
14,12,12,12,9,12,12,12,14,14,6,10,6,10,4,12,4,4,12,4,4,4,12,4,10,10,10,10,6,10,6,9,9,9,8,9,12,12,12,9,22
14,12,9,9,9,12,14,14,14,14,6,10,10,6,4,12,12,12,12,18,18,4,12,4,10,10,10,6,10,10,6,9,9,9,9,9,9,9,12,9,22
14,12,8,9,9,12,14,14,14,14,6,4,4,4,6,22,22,22,22,22,18,4,12,4,10,10,6,10,10,10,6,9,9,12,12,12,12,12,12,9,22
8,12,12,9,9,12,12,12,12,12,12,12,12,12,22,23,22,22,22,22,12,12,12,4,10,6,10,10,10,10,6,9,8,12,9,9,9,8,9,9,22
9,9,12,9,9,9,8,8,8,9,6,4,4,12,22,22,23,22,22,22,12,18,4,4,6,10,10,10,10,10,6,9,9,12,9,9,9,9,8,8,22
9,9,12,9,9,9,9,9,9,9,6,18,4,12,22,22,22,23,22,22,12,4,4,6,4,4,4,4,4,4,6,9,9,12,12,12,12,12,22,22,22
9,9,12,12,12,12,12,12,12,9,6,12,12,12,22,22,22,22,23,22,12,4,6,4,4,12,12,12,12,12,6,9,9,9,8,9,9,12,22,22,8
9,9,9,9,9,8,8,9,12,9,6,12,4,18,22,22,22,22,22,23,12,6,4,4,18,12,4,4,4,12,6,9,12,12,12,12,9,12,22,22,8
9,8,9,12,12,12,9,9,12,9,6,12,4,18,18,12,12,12,12,12,12,12,12,12,12,12,18,18,4,12,6,9,12,9,9,12,12,12,9,8,9
8,22,22,12,9,12,12,12,12,9,6,12,4,4,4,12,18,4,4,6,12,23,22,22,22,22,22,18,4,12,6,9,12,9,8,8,9,9,9,9,9
8,22,22,12,9,9,8,9,9,9,6,12,12,12,12,12,4,4,6,4,12,22,23,22,22,22,22,12,12,12,6,9,12,12,12,12,12,12,12,9,9
22,22,22,12,12,12,12,12,9,9,6,4,4,4,4,4,4,6,4,4,12,22,22,23,22,22,22,12,4,18,6,9,9,9,9,9,9,9,12,9,9
22,8,8,9,9,9,9,12,9,9,6,10,10,10,10,10,6,4,4,18,12,22,22,22,23,22,22,12,4,4,6,9,8,8,8,9,9,9,12,9,9
22,9,9,8,9,9,9,12,8,9,6,10,10,10,10,6,10,4,12,12,12,22,22,22,22,23,22,12,12,12,12,12,12,12,12,12,9,9,12,12,8
22,9,12,12,12,12,12,12,9,9,6,10,10,10,6,10,10,4,12,4,18,22,22,22,22,22,23,4,4,4,6,14,14,14,14,12,9,9,8,12,14
22,9,12,9,9,9,9,9,9,9,6,10,10,6,10,10,10,4,12,4,18,18,12,12,12,12,4,6,10,10,6,14,14,14,14,12,9,9,9,12,14
22,9,12,12,12,9,8,9,9,9,6,10,6,10,10,10,10,4,12,4,4,4,12,4,4,12,4,10,6,10,6,14,14,12,12,12,9,12,12,12,14
22,8,8,9,12,9,9,9,9,9,6,6,10,10,10,10,10,4,12,12,12,12,12,18,4,12,4,10,10,6,6,14,14,12,9,9,8,12,14,14,14
22,22,22,9,12,9,9,8,9,9,6,6,6,6,6,6,6,6,6,6,6,6,6,6,6,12,6,6,6,6,6,14,14,12,12,9,8,12,12,12,14
22,22,22,9,12,9,9,9,9,13,9,9,9,9,9,9,9,9,9,9,9,9,9,9,9,12,14,14,14,14,14,13,14,14,12,12,9,9,9,12,14
22,22,22,9,12,9,8,9,13,9,9,9,9,9,9,8,9,9,9,12,12,12,12,9,8,12,14,14,14,14,14,14,13,14,14,12,12,12,9,12,14
8,9,9,12,12,9,9,13,9,9,8,9,9,9,12,12,12,12,9,12,9,9,12,9,8,12,14,14,12,12,12,14,14,13,14,14,14,12,9,12,14
0,12,12,12,9,9,13,9,8,9,9,9,8,9,12,9,9,12,8,12,9,8,12,9,8,12,14,14,12,9,12,12,14,14,13,14,14,12,9,12,14
9,9,9,9,9,13,9,9,9,9,9,9,9,9,12,9,9,12,9,12,12,8,12,9,9,12,12,12,12,9,9,12,12,14,14,13,14,12,12,12,14
9,8,8,9,13,9,9,12,12,12,12,12,12,9,12,9,9,12,9,9,12,9,12,9,9,9,9,9,9,9,9,9,12,14,14,14,13,14,14,14,14
9,9,9,13,9,9,12,12,9,9,9,9,12,9,12,8,9,12,12,12,12,9,12,9,9,9,9,9,12,12,12,9,12,12,12,12,14,13,14,14,14
8,9,13,9,8,9,12,9,22,22,22,8,12,12,12,9,8,22,22,22,9,9,12,12,12,12,9,9,12,14,12,9,9,9,9,12,14,14,13,14,14
9,13,9,9,8,9,12,9,22,22,22,8,9,9,9,9,8,22,22,22,8,9,9,9,9,12,12,12,12,14,12,12,12,12,12,12,14,14,14,13,14
13,9,8,9,9,9,0,8,22,22,22,22,22,22,22,22,22,22,8,8,9,9,9,9,9,8,14,14,14,14,14,14,14,14,14,14,14,14,14,14,13
