10,9,9,9,9,9,9,9,9,9,9,9,9,9,9,7,6,6,6,6,6,7,7,8,8,8,8,8,8,8,8,8,8,7,2,6,6,6,7,6,10,
9,10,9,9,9,0,0,0,0,0,0,9,0,0,0,0,6,6,6,6,7,8,8,8,7,6,6,6,6,7,8,8,8,6,0,6,7,6,6,10,6,
9,9,10,9,9,0,6,6,6,6,0,9,0,6,7,0,0,0,0,6,6,8,8,8,7,6,0,0,0,7,8,8,8,6,0,6,7,6,10,6,7,
9,9,9,10,9,0,0,0,0,6,0,0,0,6,6,6,6,6,0,6,0,0,0,0,6,7,0,6,0,6,6,6,6,0,0,6,6,10,6,6,6,
9,9,9,9,10,9,9,9,0,6,7,7,6,6,6,6,6,6,0,6,0,6,6,0,6,6,0,6,0,0,0,0,0,0,6,6,10,6,7,7,6,
9,0,0,0,9,10,9,9,0,0,6,6,0,0,0,0,6,6,0,7,0,0,6,0,6,6,0,6,6,6,6,6,6,6,6,10,6,6,6,6,6,
9,0,6,0,9,9,10,9,9,0,0,6,0,9,9,0,7,6,0,7,6,0,7,0,6,6,0,6,7,6,6,6,7,6,10,6,6,0,0,0,2,
9,0,6,0,9,9,9,10,9,9,0,0,0,9,9,0,7,6,0,6,6,0,6,0,0,0,0,6,6,6,7,6,6,10,6,6,0,0,6,6,7,
9,0,6,0,0,0,9,9,10,9,9,9,9,9,9,0,7,6,0,0,0,0,6,6,6,7,6,6,6,6,6,6,10,6,7,6,0,6,8,8,8,
9,0,6,6,6,0,0,9,9,10,9,9,9,9,9,0,6,6,6,6,6,6,6,6,6,6,6,6,6,6,6,10,6,6,6,6,0,6,8,8,8,
9,0,0,0,7,6,0,0,9,9,3,3,3,3,3,0,3,3,3,3,3,3,3,3,3,3,3,3,3,3,3,6,6,7,6,6,0,6,8,8,8,
9,9,9,0,7,6,6,0,9,9,3,3,5,5,1,0,1,4,0,0,0,0,0,1,5,5,5,5,5,3,3,6,6,6,6,6,0,6,7,7,8,
9,0,0,0,6,0,0,0,9,9,3,5,3,5,1,0,1,1,0,1,1,1,0,1,5,5,5,5,3,5,3,6,6,6,7,6,0,0,0,6,8,
9,0,6,6,6,0,9,9,9,9,3,5,5,3,1,0,0,0,0,4,4,1,0,1,5,5,5,3,5,5,3,6,6,6,6,6,6,6,0,6,8,
9,0,7,6,6,0,9,9,9,9,3,1,1,1,3,8,8,8,8,8,4,1,0,1,5,5,3,5,5,5,3,6,6,0,0,0,0,0,0,6,8,
7,0,0,6,6,0,0,0,0,0,0,0,0,0,8,11,8,8,8,8,0,0,0,1,5,3,5,5,5,5,3,6,7,0,6,6,6,7,6,6,8,
6,6,0,6,6,6,7,7,7,6,3,1,1,0,8,8,11,8,8,8,0,4,1,1,3,5,5,5,5,5,3,6,6,0,6,6,6,6,7,7,8,
6,6,0,6,6,6,6,6,6,6,3,4,1,0,8,8,8,11,8,8,0,1,1,3,1,1,1,1,1,1,3,6,6,0,0,0,0,0,8,8,8,
6,6,0,0,0,0,0,0,0,6,3,0,0,0,8,8,8,8,11,8,0,1,3,1,1,0,0,0,0,0,3,6,6,6,7,6,6,0,8,8,7,
6,6,6,6,6,7,7,6,0,6,3,0,1,4,8,8,8,8,8,11,0,3,1,1,4,0,1,1,1,0,3,6,0,0,0,0,6,0,8,8,7,
6,7,6,0,0,0,6,6,0,6,3,0,1,4,4,0,0,0,0,0,0,0,0,0,0,0,4,4,1,0,3,6,0,6,6,0,0,0,6,7,6,
7,8,8,0,6,0,0,0,0,6,3,0,1,1,1,0,4,1,1,3,0,11,8,8,8,8,8,4,1,0,3,6,0,6,7,7,6,6,6,6,6,
7,8,8,0,6,6,7,6,6,6,3,0,0,0,0,0,1,1,3,1,0,8,11,8,8,8,8,0,0,0,3,6,0,0,0,0,0,0,0,6,6,
8,8,8,0,0,0,0,0,6,6,3,1,1,1,1,1,1,3,1,1,0,8,8,11,8,8,8,0,1,4,3,6,6,6,6,6,6,6,0,6,6,
8,7,7,6,6,6,6,0,6,6,3,5,5,5,5,5,3,1,1,4,0,8,8,8,11,8,8,0,1,1,3,6,7,7,7,6,6,6,0,6,6,
8,6,6,7,6,6,6,0,7,6,3,5,5,5,5,3,5,1,0,0,0,8,8,8,8,11,8,0,0,0,0,0,0,0,0,0,6,6,0,0,7,
8,6,0,0,0,0,0,0,6,6,3,5,5,5,3,5,5,1,0,1,4,8,8,8,8,8,11,1,1,1,3,9,9,9,9,0,6,6,7,0,9,
8,6,0,6,6,6,6,6,6,6,3,5,5,3,5,5,5,1,0,1,4,4,0,0,0,0,1,3,5,5,3,9,9,9,9,0,6,6,6,0,9,
8,6,0,0,0,6,7,6,6,6,3,5,3,5,5,5,5,1,0,1,1,1,0,1,1,0,1,5,3,5,3,9,9,0,0,0,6,0,0,0,9,
8,7,7,6,0,6,6,6,6,6,3,3,5,5,5,5,5,1,0,0,0,0,0,4,1,0,1,5,5,3,3,9,9,0,6,6,7,0,9,9,9,
8,8,8,6,0,6,6,7,6,6,3,3,3,3,3,3,3,3,3,3,3,3,3,3,3,0,3,3,3,3,3,9,9,0,0,6,7,0,0,0,9,
8,8,8,6,0,6,6,6,6,10,6,6,6,6,6,6,6,6,6,6,6,6,6,6,6,0,9,9,9,9,9,10,9,9,0,0,6,6,6,0,9,
8,8,8,6,0,6,7,6,10,6,6,6,6,6,6,7,6,6,6,0,0,0,0,6,7,0,9,9,9,9,9,9,10,9,9,0,0,0,6,0,9,
7,6,6,0,0,6,6,10,6,6,7,6,6,6,0,0,0,0,6,0,6,6,0,6,7,0,9,9,0,0,0,9,9,10,9,9,9,0,6,0,9,
2,0,0,0,6,6,10,6,7,6,6,6,7,6,0,6,6,0,7,0,6,7,0,6,7,0,9,9,0,6,0,0,9,9,10,9,9,0,6,0,9,
6,6,6,6,6,10,6,6,6,6,6,6,6,6,0,6,6,0,6,0,0,7,0,6,6,0,0,0,0,6,6,0,0,9,9,10,9,0,0,0,9,
6,7,7,6,10,6,6,0,0,0,0,0,0,6,0,6,6,0,6,6,0,6,0,6,6,6,6,6,6,6,6,6,0,9,9,9,10,9,9,9,9,
6,6,6,10,6,6,0,0,6,6,6,6,0,6,0,7,6,0,0,0,0,6,0,6,6,6,6,6,0,0,0,6,0,0,0,0,9,10,9,9,9,
7,6,10,6,7,6,0,6,8,8,8,7,0,0,0,6,7,8,8,8,6,6,0,0,0,0,6,6,0,9,0,6,6,6,6,0,9,9,10,9,9,
6,10,6,6,7,6,0,6,8,8,8,7,6,6,6,6,7,8,8,8,7,6,6,6,6,0,0,0,0,9,0,0,0,0,0,0,9,9,9,10,9,
10,6,7,6,6,6,2,7,8,8,8,8,8,8,8,8,8,8,7,7,6,6,6,6,6,7,9,9,9,9,9,9,9,9,9,9,9,9,9,9,10,
