4,4,4,4,4,4,4,1,4,1,1,1,1,1,4,1,1,1,1,1,2,1,4,4,4,4,4,4,4,8,8,8,8,8,8,8,8,8,8,8,11,
4,4,4,4,4,4,1,1,1,1,4,1,1,1,1,1,1,4,1,1,0,4,4,4,4,4,4,4,4,4,8,8,8,8,8,8,8,8,8,11,8,
4,4,4,4,4,1,1,0,0,0,0,0,0,0,0,0,0,0,0,0,0,0,0,4,4,4,0,0,0,0,0,0,0,8,8,8,8,8,11,8,8,
4,4,4,4,4,1,1,0,1,4,8,8,8,8,8,4,1,1,1,1,1,1,0,4,4,1,0,3,1,1,3,1,0,8,8,8,8,11,8,8,8,
4,4,4,4,4,1,1,0,0,1,4,8,8,8,8,8,4,1,1,4,4,1,0,4,1,0,0,1,3,1,1,0,0,8,8,8,11,8,8,8,8,
4,4,1,1,1,3,1,1,0,0,0,0,0,0,0,0,0,0,1,1,1,1,0,4,1,0,1,1,3,1,0,0,8,8,8,11,8,8,8,8,8,
4,1,1,1,1,1,3,1,1,1,1,1,1,1,4,1,1,0,0,0,1,1,0,1,4,0,4,1,0,0,0,8,8,8,11,8,8,8,8,8,8,
1,1,0,0,0,1,1,3,5,5,5,5,1,0,0,0,1,4,1,0,0,0,0,1,1,0,1,4,0,1,4,8,8,11,8,8,8,8,8,8,8,
4,1,0,1,0,0,1,5,5,5,5,5,1,0,1,0,0,0,1,1,0,1,1,1,1,0,4,1,0,1,4,8,11,8,8,8,0,0,0,8,8,
1,1,0,4,1,0,1,5,5,5,5,5,1,0,1,4,1,0,1,0,0,0,1,1,0,0,1,4,0,1,4,11,8,8,8,0,0,1,0,8,8,
1,4,0,8,4,0,1,5,5,5,5,5,1,0,0,0,1,0,0,0,1,0,0,0,0,1,4,1,0,1,4,4,4,4,0,0,1,3,0,8,8,
1,1,0,8,8,0,1,5,5,5,5,3,1,1,1,0,1,1,1,0,4,0,1,1,1,4,1,0,0,3,1,1,1,1,0,1,1,1,0,4,8,
1,1,0,8,8,0,1,1,1,1,1,1,3,1,1,0,1,4,1,0,4,0,1,4,4,1,0,0,3,0,0,0,0,0,0,3,3,1,0,4,4,
1,1,0,8,8,0,1,0,0,0,0,1,1,3,1,0,1,1,1,0,4,0,1,1,1,0,0,3,0,0,1,4,1,4,1,1,1,3,0,4,4,
4,1,0,8,8,0,4,0,1,1,0,1,1,1,3,0,0,0,0,0,4,0,0,0,0,0,3,0,0,1,4,1,4,1,4,1,0,0,0,4,4,
1,1,0,4,8,0,1,0,0,1,0,0,0,0,0,3,1,1,0,1,1,1,0,1,1,3,0,0,1,4,1,0,0,0,0,0,0,1,4,4,4,
1,1,0,1,4,0,1,1,0,1,1,1,1,1,0,1,3,1,0,0,0,0,0,1,3,1,0,1,4,1,0,0,1,1,4,1,1,4,4,4,4,
1,4,0,1,1,0,0,4,0,0,0,1,4,1,0,4,1,3,1,4,0,4,1,3,1,1,0,1,4,1,0,1,1,1,1,4,4,4,4,4,4,
1,1,0,1,1,1,0,1,1,1,0,1,1,1,0,0,0,1,3,4,0,4,3,1,0,0,0,1,1,1,0,1,1,0,0,0,0,0,0,4,4,
1,1,0,1,4,1,0,0,1,0,0,0,0,0,0,1,0,4,4,4,0,4,4,4,0,1,0,0,0,0,0,0,1,0,1,1,1,1,0,4,1,
2,0,0,1,4,1,1,0,0,0,1,4,4,4,4,1,0,0,0,0,0,0,0,0,0,1,4,4,4,4,1,0,0,0,1,1,4,1,0,0,2,
1,4,0,1,1,1,1,0,1,0,0,0,0,0,0,1,0,4,4,4,0,4,4,4,0,1,0,0,0,0,0,0,1,0,0,1,4,1,0,1,1,
4,4,0,0,0,0,0,0,1,1,0,1,1,1,0,0,0,1,3,4,0,4,3,1,0,0,0,1,1,1,0,1,1,1,0,1,1,1,0,1,1,
4,4,4,4,4,4,1,1,1,1,0,1,4,1,0,1,1,3,1,4,0,4,1,3,1,1,0,1,4,1,0,0,0,4,0,0,1,1,0,4,1,
4,4,4,4,1,1,4,1,1,0,0,1,4,1,0,1,3,1,0,0,0,0,0,1,3,1,0,1,1,1,1,1,0,1,1,0,4,1,0,1,1,
4,4,4,1,0,0,0,0,0,0,1,4,1,0,0,3,1,1,0,1,1,1,0,4,1,3,0,0,0,0,0,4,0,0,1,0,8,4,0,1,1,
4,4,0,0,0,1,4,1,4,1,4,1,0,0,3,0,0,0,0,0,4,0,0,0,0,0,3,1,1,1,0,1,1,0,4,0,8,8,0,1,4,
4,4,0,3,1,1,1,4,1,4,1,0,0,3,0,0,1,1,1,0,4,0,1,1,1,0,1,3,1,1,0,0,0,0,1,0,8,8,0,1,1,
4,4,0,1,3,3,0,0,0,0,0,0,3,0,0,1,4,4,1,0,4,0,1,4,1,0,1,1,3,1,1,1,1,1,1,0,8,8,0,1,1,
8,4,0,1,1,1,0,1,1,1,1,3,0,0,1,4,1,1,1,0,4,0,1,1,1,0,1,1,1,3,5,5,5,5,1,0,8,8,0,1,1,
8,8,0,3,1,0,0,4,4,4,4,1,0,1,4,1,0,0,0,0,1,0,0,0,1,0,0,0,1,5,5,5,5,5,1,0,4,8,0,4,1,
8,8,0,1,0,0,8,8,8,11,4,1,0,4,1,0,0,1,1,0,0,0,1,0,1,4,1,0,1,5,5,5,5,5,1,0,1,4,0,1,1,
8,8,0,0,0,8,8,8,11,8,4,1,0,1,4,0,1,1,1,1,0,1,1,0,0,0,1,0,1,5,5,5,5,5,1,0,0,1,0,1,4,
8,8,8,8,8,8,8,11,8,8,4,1,0,4,1,0,1,1,0,0,0,0,1,4,1,0,0,0,1,5,5,5,5,3,1,1,0,0,0,1,1,
8,8,8,8,8,8,11,8,8,8,0,0,0,1,4,0,4,1,0,1,1,0,0,0,1,1,4,1,1,1,1,1,1,1,3,1,1,1,1,1,4,
8,8,8,8,8,11,8,8,8,0,0,1,3,1,1,0,1,4,0,1,1,1,1,0,0,0,0,0,0,0,0,0,0,1,1,3,1,1,1,4,4,
8,8,8,8,11,8,8,8,0,0,1,1,3,1,0,0,1,4,0,1,4,4,1,1,4,8,8,8,8,8,4,1,0,0,1,1,4,4,4,4,4,
8,8,8,11,8,8,8,8,0,1,3,1,1,3,0,1,4,4,0,1,1,1,1,1,1,4,8,8,8,8,8,4,1,0,1,1,4,4,4,4,4,
8,8,11,8,8,8,8,8,0,0,0,0,0,0,0,4,4,4,0,0,0,0,0,0,0,0,0,0,0,0,0,0,0,0,1,1,4,4,4,4,4,
8,11,8,8,8,8,8,8,8,8,8,4,4,4,4,4,4,4,4,1,0,1,1,4,1,1,1,1,1,1,4,1,1,1,1,4,4,4,4,4,4,
11,8,8,8,8,8,8,8,8,8,8,8,4,4,4,4,4,4,4,4,2,1,1,1,1,1,4,1,1,1,1,1,4,1,4,4,4,4,4,4,4,