16,15,15,15,15,15,17,17,17,12,12,12,12,12,12,12,12,12,17,17,2,15,15,16,15,13,13,13,13,13,14,13,13,14,14,14,14,14,14,14,14,
15,16,15,15,15,17,17,12,12,12,12,12,12,12,12,12,12,17,17,15,0,15,15,15,13,13,13,13,13,13,13,13,14,13,14,14,14,14,14,14,14,
15,15,16,17,17,17,12,12,12,12,12,12,12,12,12,12,17,17,15,15,0,0,15,0,0,0,0,0,0,0,0,13,14,13,14,14,14,14,14,14,14,
15,15,17,16,12,12,12,12,12,17,17,17,17,17,17,17,17,15,16,15,15,0,0,0,13,14,14,13,13,13,0,13,13,14,14,14,14,14,14,14,14,
15,15,17,12,12,12,12,17,17,17,15,15,15,15,15,15,15,15,15,15,13,13,13,13,13,13,13,13,14,13,0,13,13,14,14,14,14,14,14,14,14,
15,17,17,12,12,12,12,17,17,15,0,0,0,0,0,0,0,0,0,13,13,13,0,0,0,0,0,0,13,13,0,13,14,14,14,14,14,14,14,14,14,
17,17,12,12,12,12,12,12,17,17,0,15,15,16,15,15,15,15,0,13,13,14,0,13,14,13,13,0,13,14,0,13,14,14,14,14,14,14,14,14,14,
17,12,12,12,17,17,12,12,12,17,0,0,0,0,15,15,15,15,0,13,13,13,0,13,13,13,0,0,13,0,0,13,14,14,14,14,14,14,13,13,14,
17,12,12,12,17,17,17,12,12,12,17,17,17,0,15,15,16,15,0,0,0,0,0,13,13,13,0,13,13,0,13,14,14,14,14,14,13,13,14,14,13,
12,12,12,17,17,15,17,17,12,12,12,12,17,0,0,0,0,15,13,13,13,13,13,13,13,14,0,0,0,0,14,14,14,13,13,13,13,13,13,13,13,
12,12,12,17,15,0,0,0,17,12,12,12,17,17,17,17,0,15,0,0,0,0,0,0,0,13,13,13,13,14,14,14,13,0,0,0,0,0,0,13,14,
12,12,12,17,15,0,15,0,17,12,12,12,12,12,12,17,0,15,0,13,13,13,14,13,0,14,13,14,14,14,14,0,0,0,14,13,13,13,0,13,13,
12,12,12,17,15,0,15,0,17,17,17,12,12,12,12,17,0,16,0,13,13,14,13,13,0,13,14,14,14,14,14,0,13,13,13,13,14,13,0,13,13,
12,12,12,17,15,0,16,0,0,0,17,12,12,12,12,17,0,15,0,15,0,0,0,13,0,13,14,14,14,14,13,0,13,0,0,0,13,13,0,14,13,
12,12,12,17,15,0,15,15,15,0,17,12,12,12,12,17,0,15,0,15,0,13,0,0,0,14,14,14,14,13,13,0,0,0,13,0,13,14,0,13,13,
12,12,12,17,15,0,15,15,15,0,17,17,17,17,17,16,0,0,0,15,0,14,13,13,14,14,14,13,13,14,13,14,13,13,13,0,13,14,0,13,13,
12,12,17,17,15,0,15,15,16,0,0,0,0,0,0,0,16,15,15,15,0,13,13,14,14,14,0,0,0,0,0,13,13,13,14,0,13,13,0,13,15,
12,17,17,15,15,0,15,15,15,15,15,15,16,15,15,0,15,16,16,15,0,13,14,14,14,13,0,13,13,13,0,13,13,13,13,0,13,0,0,15,16,
17,17,15,16,15,0,0,0,0,13,0,0,0,0,0,0,15,16,16,15,0,14,14,14,13,13,0,0,13,14,0,13,0,0,0,0,13,0,15,15,15,
17,15,15,15,15,13,13,13,0,13,0,13,13,15,15,15,15,15,15,16,0,14,14,13,13,14,13,0,14,13,0,14,0,13,14,13,13,0,0,15,15,
2,0,0,15,13,13,13,13,0,13,0,13,13,0,0,0,0,0,0,0,0,0,0,0,0,0,0,0,13,13,0,13,0,13,13,13,13,15,0,0,2,
15,15,0,0,13,13,14,13,0,14,0,13,14,0,13,14,13,13,14,14,0,16,15,15,15,15,15,15,13,13,0,13,0,13,13,13,15,15,15,15,17,
15,15,15,0,13,0,0,0,0,13,0,14,13,0,0,13,13,14,14,14,0,15,16,16,15,0,0,0,0,0,0,13,0,0,0,0,15,16,15,17,17,
16,15,0,0,13,0,13,13,13,13,0,13,13,13,0,13,14,14,14,13,0,15,16,16,15,0,15,15,16,15,15,15,15,15,15,0,15,15,17,17,12,
15,13,0,13,13,0,14,13,13,13,0,0,0,0,0,14,14,14,13,13,0,15,15,15,16,0,0,0,0,0,0,0,16,15,15,0,15,17,17,12,12,
13,13,0,14,13,0,13,13,13,14,13,14,13,13,14,14,14,13,13,14,0,15,0,0,0,16,17,17,17,17,17,0,15,15,15,0,15,17,12,12,12,
13,13,0,14,13,0,13,0,0,0,13,13,14,14,14,14,0,0,0,13,0,15,0,15,0,17,12,12,12,12,17,0,15,15,15,0,15,17,12,12,12,
13,14,0,13,13,0,0,0,13,0,13,14,14,14,14,13,0,13,0,0,0,15,0,15,0,17,12,12,12,12,17,0,0,0,16,0,15,17,12,12,12,
13,13,0,13,14,13,13,13,13,0,13,14,14,14,14,13,0,13,13,14,13,13,0,16,0,17,12,12,12,12,17,17,17,0,15,0,15,17,12,12,12,
13,13,0,13,13,13,14,0,0,0,14,14,14,14,13,14,0,13,14,13,13,13,0,15,0,17,12,12,12,12,12,12,17,0,15,0,15,17,12,12,12,
14,13,0,0,0,0,0,0,13,14,14,14,13,13,13,13,0,0,0,0,0,0,0,15,0,17,17,17,17,12,12,12,17,0,0,0,15,17,12,12,12,
13,13,13,13,13,13,13,13,14,14,14,0,0,0,0,14,13,13,13,14,13,13,13,15,0,0,0,0,17,12,12,12,12,17,17,15,17,17,12,12,12,
13,14,14,13,13,14,14,14,14,14,13,0,13,13,0,13,13,13,0,0,0,0,0,15,16,15,15,0,17,17,17,12,12,12,17,17,17,12,12,12,17,
14,13,13,14,14,14,14,14,14,13,0,0,13,0,0,13,13,13,0,13,13,13,0,15,15,15,15,0,0,0,0,17,12,12,12,17,17,12,12,12,17,
14,14,14,14,14,14,14,14,14,13,0,14,13,0,13,13,14,13,0,14,13,13,0,15,15,15,15,16,15,15,0,17,17,12,12,12,12,12,12,17,17,
14,14,14,14,14,14,14,14,14,13,0,13,13,0,0,0,0,0,0,13,13,13,0,0,0,0,0,0,0,0,0,15,17,17,12,12,12,12,17,17,15,
14,14,14,14,14,14,14,14,13,13,0,13,14,13,13,13,13,13,13,13,13,15,15,15,15,15,15,15,15,15,15,17,17,17,12,12,12,12,17,15,15,
14,14,14,14,14,14,14,14,13,13,0,13,13,13,14,14,13,0,0,0,15,15,16,15,17,17,17,17,17,17,17,17,12,12,12,12,12,16,17,15,15,
14,14,14,14,14,14,14,13,14,13,0,0,0,0,0,0,0,0,15,0,0,15,15,17,17,12,12,12,12,12,12,12,12,12,12,17,17,17,16,15,15,
14,14,14,14,14,14,14,13,14,13,13,13,13,14,13,13,13,15,15,15,0,15,17,17,12,12,12,12,12,12,12,12,12,12,17,17,15,15,15,16,15,
14,14,14,14,14,14,14,14,13,13,14,13,13,13,13,13,15,16,15,15,2,17,17,12,12,12,12,12,12,12,12,12,17,17,17,15,15,15,15,15,16,
