4,3,3,3,3,3,18,18,18,8,8,8,8,8,8,8,8,8,18,18,0,3,3,4,3,17,17,17,17,17,13,17,17,13,13,13,13,13,13,13,13
3,4,3,3,3,18,18,8,8,8,8,8,8,8,8,8,8,18,18,3,11,3,3,3,17,17,17,17,17,17,17,17,13,17,13,13,13,13,13,13,13
3,3,4,18,18,18,8,8,8,8,8,8,8,8,8,8,18,18,3,3,11,11,3,11,11,11,11,11,11,11,11,17,13,17,13,13,13,13,13,13,13
3,3,18,4,8,8,8,8,8,18,18,18,18,18,18,18,18,3,4,3,3,11,11,11,17,13,13,17,17,17,11,17,17,13,13,13,13,13,13,13,13
3,3,18,8,8,8,8,18,18,18,3,3,3,3,3,3,3,3,3,3,17,17,17,17,17,17,17,17,13,17,11,17,17,13,13,13,13,13,13,13,13
3,18,18,8,8,8,8,18,18,3,11,11,11,11,11,11,11,11,11,17,17,17,11,11,11,11,11,11,17,17,11,17,13,13,13,13,13,13,13,13,13
18,18,8,8,8,8,8,8,18,18,11,3,3,4,3,3,3,3,11,17,17,13,11,17,13,17,17,11,17,13,11,17,13,13,13,13,13,13,13,13,13
18,8,8,8,18,18,8,8,8,18,11,11,11,11,3,3,3,3,11,17,17,17,11,17,17,17,11,11,17,11,11,17,13,13,13,13,13,13,17,17,13
18,8,8,8,18,18,18,8,8,8,18,18,18,11,3,3,4,3,11,11,11,11,11,17,17,17,11,17,17,11,17,13,13,13,13,13,17,17,13,13,17
8,8,8,18,18,3,18,18,8,8,8,8,18,11,11,11,11,3,17,17,17,17,17,17,17,13,11,11,11,11,13,13,13,17,17,17,17,17,17,17,17
8,8,8,18,3,11,11,11,18,8,8,8,18,18,18,18,11,3,11,11,11,11,11,11,11,17,17,17,17,13,13,13,17,11,11,11,11,11,11,17,13
8,8,8,18,3,11,3,11,18,8,8,8,8,8,8,18,11,3,11,17,17,17,13,17,11,13,17,13,13,13,13,11,11,11,13,17,17,17,11,17,17
8,8,8,18,3,11,3,11,18,18,18,8,8,8,8,18,11,4,11,17,17,13,17,17,11,17,13,13,13,13,13,11,17,17,17,17,13,17,11,17,17
8,8,8,18,3,11,4,11,11,11,18,8,8,8,8,18,11,3,11,3,11,11,11,17,11,17,13,13,13,13,17,11,17,11,11,11,17,17,11,13,17
8,8,8,18,3,11,3,3,3,11,18,8,8,8,8,18,11,3,11,3,11,17,11,11,11,13,13,13,13,17,17,11,11,11,17,11,17,13,11,17,17
8,8,8,18,3,11,3,3,3,11,18,18,18,18,18,4,11,11,11,3,11,13,17,17,13,13,13,17,17,13,17,13,17,17,17,11,17,13,11,17,17
8,8,18,18,3,11,3,3,4,11,11,11,11,11,11,11,4,3,3,3,11,17,17,13,13,13,11,11,11,11,11,17,17,17,13,11,17,17,11,17,3
8,18,18,3,3,11,3,3,3,3,3,3,4,3,3,11,3,4,4,3,11,17,13,13,13,17,11,17,17,17,11,17,17,17,17,11,17,11,11,3,4
18,18,3,4,3,11,11,11,11,17,11,11,11,11,11,11,3,4,4,3,11,13,13,13,17,17,11,11,17,13,11,17,11,11,11,11,17,11,3,3,3
18,3,3,3,3,17,17,17,11,17,11,17,17,3,3,3,3,3,3,4,11,13,13,17,17,13,17,11,13,17,11,13,11,17,13,17,17,11,11,3,3
0,11,11,3,17,17,17,17,11,17,11,17,17,11,11,11,11,11,11,11,11,11,11,11,11,11,11,11,17,17,11,17,11,17,17,17,17,3,11,11,0
3,3,11,11,17,17,13,17,11,13,11,17,13,11,17,13,17,17,13,13,11,4,3,3,3,3,3,3,17,17,11,17,11,17,17,17,3,3,3,3,18
3,3,3,11,17,11,11,11,11,17,11,13,17,11,11,17,17,13,13,13,11,3,4,4,3,11,11,11,11,11,11,17,11,11,11,11,3,4,3,18,18
4,3,11,11,17,11,17,17,17,17,11,17,17,17,11,17,13,13,13,17,11,3,4,4,3,11,3,3,4,3,3,3,3,3,3,11,3,3,18,18,8
3,17,11,17,17,11,13,17,17,17,11,11,11,11,11,13,13,13,17,17,11,3,3,3,4,11,11,11,11,11,11,11,4,3,3,11,3,18,18,8,8
17,17,11,13,17,11,17,17,17,13,17,13,17,17,13,13,13,17,17,13,11,3,11,11,11,4,18,18,18,18,18,11,3,3,3,11,3,18,8,8,8
17,17,11,13,17,11,17,11,11,11,17,17,13,13,13,13,11,11,11,17,11,3,11,3,11,18,8,8,8,8,18,11,3,3,3,11,3,18,8,8,8
17,13,11,17,17,11,11,11,17,11,17,13,13,13,13,17,11,17,11,11,11,3,11,3,11,18,8,8,8,8,18,11,11,11,4,11,3,18,8,8,8
17,17,11,17,13,17,17,17,17,11,17,13,13,13,13,17,11,17,17,13,17,17,11,4,11,18,8,8,8,8,18,18,18,11,3,11,3,18,8,8,8
17,17,11,17,17,17,13,11,11,11,13,13,13,13,17,13,11,17,13,17,17,17,11,3,11,18,8,8,8,8,8,8,18,11,3,11,3,18,8,8,8
13,17,11,11,11,11,11,11,17,13,13,13,17,17,17,17,11,11,11,11,11,11,11,3,11,18,18,18,18,8,8,8,18,11,11,11,3,18,8,8,8
17,17,17,17,17,17,17,17,13,13,13,11,11,11,11,13,17,17,17,13,17,17,17,3,11,11,11,11,18,8,8,8,8,18,18,3,18,18,8,8,8
17,13,13,17,17,13,13,13,13,13,17,11,17,17,11,17,17,17,11,11,11,11,11,3,4,3,3,11,18,18,18,8,8,8,18,18,18,8,8,8,18
13,17,17,13,13,13,13,13,13,17,11,11,17,11,11,17,17,17,11,17,17,17,11,3,3,3,3,11,11,11,11,18,8,8,8,18,18,8,8,8,18
13,13,13,13,13,13,13,13,13,17,11,13,17,11,17,17,13,17,11,13,17,17,11,3,3,3,3,4,3,3,11,18,18,8,8,8,8,8,8,18,18
13,13,13,13,13,13,13,13,13,17,11,17,17,11,11,11,11,11,11,17,17,17,11,11,11,11,11,11,11,11,11,3,18,18,8,8,8,8,18,18,3
13,13,13,13,13,13,13,13,17,17,11,17,13,17,17,17,17,17,17,17,17,3,3,3,3,3,3,3,3,3,3,18,18,18,8,8,8,8,18,3,3
13,13,13,13,13,13,13,13,17,17,11,17,17,17,13,13,17,11,11,11,3,3,4,3,18,18,18,18,18,18,18,18,8,8,8,8,8,4,18,3,3
13,13,13,13,13,13,13,17,13,17,11,11,11,11,11,11,11,11,3,11,11,3,3,18,18,8,8,8,8,8,8,8,8,8,8,18,18,18,4,3,3
13,13,13,13,13,13,13,17,13,17,17,17,17,13,17,17,17,3,3,3,11,3,18,18,8,8,8,8,8,8,8,8,8,8,18,18,3,3,3,4,3
13,13,13,13,13,13,13,13,17,17,13,17,17,17,17,17,3,4,3,3,0,18,18,8,8,8,8,8,8,8,8,8,18,18,18,3,3,3,3,3,4
