4,4,4,4,4,4,4,4,4,4,4,4,4,4,4,4,4,4,4,4,2,4,4,4,4,4,4,4,4,4,4,4,4,4,4,4,4,4,4,4,4,
4,8,8,8,8,8,8,8,4,1,1,1,1,1,1,1,1,1,1,1,0,1,1,1,1,1,1,1,1,1,1,1,4,8,8,8,8,8,8,8,4,
4,8,11,11,8,11,11,8,4,1,0,0,0,0,0,0,0,0,0,0,0,0,0,0,0,0,0,0,0,0,0,1,4,8,11,11,8,11,11,8,4,
4,8,11,8,8,8,11,8,4,1,0,8,8,8,8,8,8,8,8,8,8,8,8,8,8,8,8,8,8,8,0,1,4,8,11,8,8,8,11,8,4,
4,8,8,8,8,8,8,8,4,1,0,8,0,0,0,0,0,0,0,0,0,0,0,0,0,0,0,0,0,8,0,1,4,8,8,8,8,8,8,8,4,
4,8,11,8,8,8,11,8,4,1,0,8,0,1,1,1,5,1,1,1,0,1,1,1,5,1,1,1,0,8,0,1,4,8,11,8,8,8,11,8,4,
4,8,11,11,8,11,11,8,4,1,0,0,0,1,0,0,0,0,0,0,0,0,0,0,0,0,0,1,0,0,0,1,4,8,11,11,8,11,11,8,4,
4,8,8,8,8,8,8,8,4,1,1,1,1,1,0,8,8,8,8,8,8,8,8,8,8,8,0,1,1,1,1,1,4,8,8,8,8,8,8,8,4,
4,4,4,4,4,4,4,4,4,1,1,1,1,1,0,8,0,0,0,8,8,8,0,0,0,8,0,1,1,1,1,1,4,4,4,4,4,4,4,4,4,
4,1,1,1,1,1,1,1,1,4,4,4,1,1,0,0,0,1,0,0,0,0,0,1,0,0,0,1,1,4,4,4,1,1,1,1,1,1,1,1,4,
4,1,0,0,0,0,0,1,1,4,4,4,1,1,5,1,1,1,1,1,0,1,1,1,1,1,5,1,1,4,4,4,1,1,0,0,0,0,0,1,4,
4,1,0,8,8,8,0,1,1,4,4,4,1,1,1,0,0,0,0,5,0,5,0,0,0,0,1,1,1,4,4,4,1,1,0,8,8,8,0,1,4,
4,1,0,8,0,0,0,1,1,1,1,1,4,1,1,0,8,8,0,1,0,1,0,8,8,0,1,1,4,1,1,1,1,1,0,0,0,8,0,1,4,
4,1,0,8,0,1,1,1,1,1,1,1,1,4,1,0,0,8,0,0,0,0,0,8,0,0,1,4,1,1,1,1,1,1,1,1,0,8,0,1,4,
4,1,0,8,0,1,0,0,0,0,5,1,1,1,4,1,0,8,8,8,8,8,8,8,0,1,4,1,1,1,5,0,0,0,0,1,0,8,0,1,4,
4,1,0,8,0,1,0,8,8,0,1,0,0,0,1,4,0,0,0,0,0,0,0,0,0,4,1,0,0,0,1,0,8,8,0,1,0,8,0,1,4,
4,1,0,8,0,5,0,8,0,0,1,0,8,0,0,0,4,1,1,1,0,1,1,1,4,0,0,0,8,0,1,0,0,8,0,5,0,8,0,1,4,
4,1,0,8,0,1,0,8,0,1,1,0,8,8,8,0,1,4,4,1,0,1,4,4,1,0,8,8,8,0,1,1,0,8,0,1,0,8,0,1,4,
4,1,0,8,0,1,0,8,0,0,1,0,0,0,8,0,1,4,4,1,0,1,4,4,1,0,8,0,0,0,1,0,0,8,0,1,0,8,0,1,4,
4,1,0,8,0,1,0,8,8,0,1,5,1,0,8,0,1,1,1,4,0,4,1,1,1,0,8,0,1,5,1,0,8,8,0,1,0,8,0,1,4,
2,0,0,8,0,0,0,8,8,0,0,0,0,0,8,0,0,0,0,0,0,0,0,0,0,0,8,0,0,0,0,0,8,8,0,0,0,8,0,0,2,
4,1,0,8,0,1,0,8,8,0,1,5,1,0,8,0,1,1,1,4,0,4,1,1,1,0,8,0,1,5,1,0,8,8,0,1,0,8,0,1,4,
4,1,0,8,0,1,0,8,0,0,1,0,0,0,8,0,1,4,4,1,0,1,4,4,1,0,8,0,0,0,1,0,0,8,0,1,0,8,0,1,4,
4,1,0,8,0,1,0,8,0,1,1,0,8,8,8,0,1,4,4,1,0,1,4,4,1,0,8,8,8,0,1,1,0,8,0,1,0,8,0,1,4,
4,1,0,8,0,5,0,8,0,0,1,0,8,0,0,0,4,1,1,1,0,1,1,1,4,0,0,0,8,0,1,0,0,8,0,5,0,8,0,1,4,
4,1,0,8,0,1,0,8,8,0,1,0,0,0,1,4,0,0,0,0,0,0,0,0,0,4,1,0,0,0,1,0,8,8,0,1,0,8,0,1,4,
4,1,0,8,0,1,0,0,0,0,5,1,1,1,4,1,0,8,8,8,8,8,8,8,0,1,4,1,1,1,5,0,0,0,0,1,0,8,0,1,4,
4,1,0,8,0,1,1,1,1,1,1,1,1,4,1,0,0,8,0,0,0,0,0,8,0,0,1,4,1,1,1,1,1,1,1,1,0,8,0,1,4,
4,1,0,8,0,0,0,1,1,1,1,1,4,1,1,0,8,8,0,1,0,1,0,8,8,0,1,1,4,1,1,1,1,1,0,0,0,8,0,1,4,
4,1,0,8,8,8,0,1,1,4,4,4,1,1,1,0,0,0,0,5,0,5,0,0,0,0,1,1,1,4,4,4,1,1,0,8,8,8,0,1,4,
4,1,0,0,0,0,0,1,1,4,4,4,1,1,5,1,1,1,1,1,0,1,1,1,1,1,5,1,1,4,4,4,1,1,0,0,0,0,0,1,4,
4,1,1,1,1,1,1,1,1,4,4,4,1,1,0,0,0,1,0,0,0,0,0,1,0,0,0,1,1,4,4,4,1,1,1,1,1,1,1,1,4,
4,4,4,4,4,4,4,4,4,1,1,1,1,1,0,8,0,0,0,8,8,8,0,0,0,8,0,1,1,1,1,1,4,4,4,4,4,4,4,4,4,
4,8,8,8,8,8,8,8,4,1,1,1,1,1,0,8,8,8,8,8,8,8,8,8,8,8,0,1,1,1,1,1,4,8,8,8,8,8,8,8,4,
4,8,11,11,8,11,11,8,4,1,0,0,0,1,0,0,0,0,0,0,0,0,0,0,0,0,0,1,0,0,0,1,4,8,11,11,8,11,11,8,4,
4,8,11,8,8,8,11,8,4,1,0,8,0,1,1,1,5,1,1,1,0,1,1,1,5,1,1,1,0,8,0,1,4,8,11,8,8,8,11,8,4,
4,8,8,8,8,8,8,8,4,1,0,8,0,0,0,0,0,0,0,0,0,0,0,0,0,0,0,0,0,8,0,1,4,8,8,8,8,8,8,8,4,
4,8,11,8,8,8,11,8,4,1,0,8,8,8,8,8,8,8,8,8,8,8,8,8,8,8,8,8,8,8,0,1,4,8,11,8,8,8,11,8,4,
4,8,11,11,8,11,11,8,4,1,0,0,0,0,0,0,0,0,0,0,0,0,0,0,0,0,0,0,0,0,0,1,4,8,11,11,8,11,11,8,4,
4,8,8,8,8,8,8,8,4,1,1,1,1,1,1,1,1,1,1,1,0,1,1,1,1,1,1,1,1,1,1,1,4,8,8,8,8,8,8,8,4,
4,4,4,4,4,4,4,4,4,4,4,4,4,4,4,4,4,4,4,4,2,4,4,4,4,4,4,4,4,4,4,4,4,4,4,4,4,4,4,4,4,
